TW5
25 16
*************************
*              *        *
*      B  *        *    *
*         *      *      *
*     **        *       *
*  *****          *     *
*            *          *
*            *    **    *
*     *    *      **   **
*     *        *        *
*        **             *
*                 **    *
*    ***   **    *+     *
*     **   *      * *   *
*                       *
*************************
