TW16
25 16
*************************
*           #           *
*           #           *
*           #           *
*           #           *
*           #           *
*           #           *
*           #           *
*    B      #           *
*        K  #      +    *
*           #           *
*           #           *
*           #           *
*           #           *
*           #           *
*************************
